###################
#.....#...........#
#.#.#.#####.#.#.#.#
#.........#.......#
#.#.#.#####.#.#.#.#
#.#...............#
#.#.#.#.###.#.#.#.#
#.#...............#
###.#.#.#.#.#.#.#.#
#.................#
###################
